"coder_id","s1_papers","s1_reject","s1_accept","acc_rate","s1_last_date"
"A_Herzberger",68,44,24,0.3529,2020-06-29 09:34:41
"A_Torres",56,46,10,0.1786,2020-05-24 16:46:16
"C_Hovis",96,73,23,0.2396,2020-09-01 17:40:24
"E_Dean",48,36,12,0.25,2020-05-15 14:07:29
"E_Xing",48,36,12,0.25,2020-05-14 20:40:24
"K_Kapsar",57,42,15,0.2632,2020-05-28 17:13:19
"M_Lei",48,28,20,0.4167,2020-05-25 23:39:32
"MG_Chung",48,38,10,0.2083,2020-04-02 22:00:48
"X_Wu",72,51,21,0.2917,2020-05-19 21:18:22
"Y_Dou",10,8,2,0.2,2020-03-20 06:22:34
"Y_Li",35,32,3,0.0857,2020-05-29 23:33:49
"Y_Zhang",57,41,16,0.2807,2020-05-26 10:55:13
